##################################################################
#                                                                #
#                                                                #
#                                                                #
#                                                                #
#                                                                #
#                                                                #
#                                                                #
#                                                                #
#                                                                #
#                       P]]]]%                                   #
#                                                                #
#                                                                #
#                                                                #
#                                                                #
#                                                                #
#                                                                #
#                                                                #
#                                                                #
#                                                                #
#                                                                #
#                                                                #
#                                                                #
#                                                                #
##################################################################