##################################################################
#~      YYYYYYYYYYYYYYYYYYYQMMMMMMMMMM*****MMMMMMMMMMMMMMMMXX##DL#
#   PAB MMM<MMMMMMMMMMMMMMMMMMMMMMMMMM*****MMMMM"MMMTTMMMMMXX#D###
#       MMMMMMMMMMMMMMMMMMMMMMMMMMMMMM*****MMMMMMMMMTTMMMMMXXD####
#MM MMMMMMMMMMMMMMMMM?MMMMMMMMMMMMMMMMMM)MMMMMMMMMMMMMMMMMMXXXXXX#
#MM MMMMMMMMMMMMMMMMMMM   MMMMMMMMMMMMMM)MMMMMMMMMMMMMMMMMMXXXXXX#
#MM MMMM      MMMMMMM MMM MMMMMMMMMMMMMM                MMMMMMMMM#
#MM MMM MMMMM MMMMMMM MMM MMMMWWWMMMMMMMMMMMMMMMMMMMMMM          #
#MM MMMM MMMM MMMMMMMMMMMBMMMMWWWMMMMMMMMMMMMMMMMMMMMMM MMMMMMMMM#
#MM MMM MMMMMWMMMMMMM MMMMMMMMWWWMMMMMMMMMMMMMMMMMMMMMM MMMWWWMMM#
#WM MMMM MMMM MMMMMMM MMMMMMMMMMMMMMMM    MM    MMMMMMM MMMWWWMMM#
#WM MMM MMMMM MMMMMMM MMMMMMMMMMMMMMMM MM MM MM MMMMMMM MMMMMMMMM#
#WM MMM MMMMM MMMMMMMMMMMMMMMMMMMMMMMM MM MM MM MMM|MMM          #
#WMWMMM MMMMM                          MM    MM MMMMMMMM MMMMMMM #
#WMAMMM MMMMMMMMMMMMMMMMMMMMMMMMMMMMMMMMMMMMMMM  MMMMMMM MMMCMMM #
#WM MMM MMMMMMMMMMMMMMMMMMMMMMMMMMMMMMMMMMMMMMMM MMMMMMM MM MMMM #
#WM MMM                                   W  MMM     MMM M MMMMM #
#MM MMMMMMMMM MMMM MMMMMMMMMMMMMMMMMMMMMMMMM MMMMMMM MMM  MMMMM M#
#MM MMMMMMMMM MMMM+MMMMMMMMMMMMMMMMMMMMMMMMM MMMMMMM MMMMMMMMM MM#
#MM   MMMMMMM!MMMMMMMMMMMWWWWWWWW        MMM MMM     MMMMMMMM MMM#
#MMMMM  MMMMMMMMMMMMMMMMMMMMMMMMMMMM MMM MM  MMM MMMMMMMMMMM MMMM#
#MMMMMMM  MMMMMMMMM                  MMM MM MMMM MMMMMMMMMM MMMMM#
#MMMMMMMMM  MM  MM M               MMMMM M MMMMM   M M M M MMM   #
#[MMMMMMMMMM  MM  MM bbbbbbbbbbbbb MMMMM   MMMMMMMM M M M MMMM  K#
##################################################################